Абонемент – абонент
Авторитарный(политический режим) – авторитетный(тот, у кого высокий авторитет)
Адресант(тот, кто адресует) – адресат(тот, кому адресовано)
Артистический – артистичный
Бедный(тот, у кого нет имущества/бедность) – бедственный (тот, к-ый приносит беды, проблемы)
Безликий(тот, у к-ого нет лица) – безличный(тот, у к-ого нет личности, слабоя личность)
Безответный(чтото без ответа) – безответственный(тот, к-ому всё равно на ответсвенность)
Болотистый – болотный
Благодарный(тот, к-ый благодарен) – благодарственный(что-то в благодарность)
Благотворительный – благотворный
Будний – будничный
Бывалый(тот, кто был в таких ситуациях) – бывший(тот, кто был кем-то) – былой(что-то в прошлом)
Ванна(предмет,конструкция, в чём моешься) – ванная(комната, помещение)
Вдох(набирание воздуха) – вздох(вдох и происходящий за ним выдох)
Вековой – вечный
Великий – величавый – величественный
Величие(черта) – величина(единица измерения)
Возбуждать – побуждать
Восполнить – дополнить – заполнить – наполнить – переполнить – пополнить
Враждебный() – вражеский(что-то, относящиеся к врагу)
Выбирать – избирать
Выгода – выгодность
Выдача – отдача – передача – раздача
Выплата – оплата – плата – уплата
Выплатить – заплатить – оплатить – отплатить – уплатить
Вырастить – нарастить – отрастить
Выращивание – наращивание – отращивание
Высокий – высотный
Гарантийный – гарантированный
Гармонический – гармоничный
Глинистый – глиняный
Годичный – годовалый – годовой
Гордость – гордыня
Гуманизм – гуманность
Гуманистический – гуманитарный – гуманный
Двоичный – двойной – двойственный – двоякий – сдвоенный – удвоенный
Действенный(что-то хороош действует|действенное лекарство) – действительный(не мнимый, оно существует) – действующий(тот, кто действует)
Деловитый – деловой – дельный – деляческий
Демократичный – демократический
Дипломант – дипломат
Дипломатический – дипломатичный
Длинный(большая длина|провода) – длительный(большой промежуток времени)
Добротный(хорошего качества) – добрый(черта характера)
Доверительный(что-то чему доверяют) – доверчивый(тот, кто легко доверяет)
Дождевой(что-то от дождя) – дождливый(характеристика погоды)
Драматический – драматичный
Дружеский – дружественный – дружный
Единичный – единственный – единый – одиночный
Желанный – желательный
Жестокий – жёсткий
Жизненный – житейский
Жилищный – жилой
Загородить – огородить – оградить – отгородить – перегородить
Занизить – понизить – снизить
Зачинатель – зачинщик
Звериный – зверский
Звуковой – звучный
Землистый – земляной – земной
Зрительный(что-то, свзязанное со взглядом, зрением) – зрительский(что-то, связанное со зрителем)
Изобретательный – изобретательский
Информативный – информационный
Информация – информированность
Иронический – ироничный
Искусный – искусственный
Исполнительный – исполнительский
Исходный – исходящий
Каменистый – каменный
Комфортабельный – комфортный
Конный – конский
Коренастый – коренной – корневой
Костный – костяной
Красочный – красящий – крашеный
Лакированный – лакировочный – лаковый
Ледовый – ледяной
Лесистый – лесной
Личностный – личный
Микроскопический – микроскопичный
Мороженый – морозильный – морозный
Наблюдательный – наблюдательский
Надеть – одеть
Наличие – наличность
Напоминание – упоминание
Невежа – невежда
Нестерпимый – нетерпеливый – нетерпимый
Неудачный – неудачливый
Обвинённый – обвинительный
Обрывок – отрывок
Обсудить – осудить
Обхватить – охватить
Ограничить – отграничить – разграничить
Оклик – отклик
Опасливый – опасный
Органический – органичный
Отборный – отборочный
Отклонение – уклонение
Отклониться – уклониться
Отличать(-ся) – различать(-ся)
Отличие – различие
Памятливый – памятный
Перетерпеть – претерпеть
Покупательный – покупательский – покупной
Понятливый – понятный
Популистский – популярный
Поступок – проступок
Почтенный – почтительный – почётный
Праздничный – праздный
Практический – практичный
Предоставить – представить
Представительный – представительский
Признанный – признательный
Подделка – поделка – проделка
Продуктивный – продуктовый
Производительность – производство
Производительный – производный – производственный
Просветительский – просвещённый
Публицистический – публицистичный
Пугливый – пуганый
Раздражение – раздражительность
Расчётливый – расчётный
Ритмический – ритмичный
Романтический – романтичный
Складной – складской
Скрытный – скрытый
Словарный – словесный
Сопротивление – сопротивляемость
Соседний – соседский
Сравнимый – сравнительный
Стеклянный – стекольный
Сценический – сценичный
Сытный – сытый
Технический – техничный
Удачливый – удачный
Униженный – унизительный
Хищнический – хищный
Царский – царственный – царствующий
Целый – цельный – целостный
Человечный – человеческий
Экономика – экономия
Экономический – экономичный – экономный
Эстетический – эстетичный
Этический – этичный
Эффективный – эффектный
Эффективность – эффектность
Яблочный – яблоневый