noun
--------------------------------------------------------------------------------------------------------------------------
renown - известность
encouragement - поощрение
feature - особенность, характерная черта
functionality - функциональность
iterations - итерации
brackets - скобки
expression - выражение
advantages  - преимущества
way - способ
__________________________________________________________________________________________________________________________
verb
--------------------------------------------------------------------------------------------------------------------------
encourage - поощрять
construct - создавать
consists - состоит
Require - требовать, требуется
__________________________________________________________________________________________________________________________
adjective
--------------------------------------------------------------------------------------------------------------------------
encouraging - обнадеживающий
renowned - известный
efficient - эффективный
distinctive - отличительный, характерный
powerful - мощный
functional - функциональный
containing - содержащий
various - различный, разнообразный
_________________________________________________________________________________________________________________________
pretext
--------------------------------------------------------------------------------------------------------------------------
for - для
almost - почти (не предлог)
within - в, в пределах
of - из
from - из
each - каждый
along - вместе
fewer - меньше (не предлог)
through - через
across - через

__________________________________________________________________________________________________________________________
постоянно забываю
--------------------------------------------------------------------------------------------------------------------------
there - там
this - это, этот
that - что, тот
them - их
where - где
When - когда
which - который, какой
__________________________________________________________________________________________________________________________
phrase
--------------------------------------------------------------------------------------------------------------------------
One of the most - Один из самых
However - тем не мение
__________________________________________________________________________________________________________________________